Halle Vaughn: seafood,grains,fats/oils,eggs,meat,alcohol,beverages,
Remy Wells: beverages,vegetables,confections,alcohol,grains,meat,fruit,
Cecilia Griffith: fats/oils,dairy,fruit,eggs,legumes/nuts/seeds,grains,
Franklin Mueller: seafood,fruit,confections,meat,eggs,alcohol,
Imani Stewart: meat,eggs,alcohol,fruit,
Nolan Pollard: beverages,fruit,vegetables,grains,
Marisol Ashley: beverages,dairy,seafood,eggs,confections,meat,
Kylen Pineda: legumes/nuts/seeds,confections,vegetables,grains,fruit,dairy,
Nola Harvey: dairy,legumes/nuts/seeds,eggs,meat,confections,beverages,
Cayden Wyatt: beverages,eggs,legumes/nuts/seeds,alcohol,vegetables,seafood,fats/oils,
Liberty Simpson: eggs,dairy,vegetables,alcohol,beverages,grains,
Elliott Harding: meat,beverages,grains,
Aniya Blake: meat,alcohol,vegetables,legumes/nuts/seeds,seafood,fats/oils,
Zyaire Reyes: confections,dairy,seafood,vegetables,
Audrey Owens: fats/oils,meat,confections,
Adriel Herman: confections,fats/oils,dairy,
Paulina Rowland: confections,eggs,fruit,fats/oils,
Eliezer Mayer: legumes/nuts/seeds,alcohol,seafood,eggs,fats/oils,fruit,
Ainhoa Griffin: eggs,confections,vegetables,
Ayden Benton: beverages,grains,confections,legumes/nuts/seeds,meat,
Anais Foster: dairy,vegetables,legumes/nuts/seeds,seafood,eggs,meat,
Kayden Jensen: vegetables,grains,beverages,legumes/nuts/seeds,eggs,seafood,
Jane Daniel: alcohol,eggs,confections,
Grady Buckley: seafood,meat,legumes/nuts/seeds,vegetables,fats/oils,fruit,
Theodora Santos: eggs,fats/oils,alcohol,meat,fruit,confections,dairy,
Walker Palmer: fruit,beverages,seafood,
Juniper Melton: dairy,eggs,beverages,confections,
Lennon Valenzuela: alcohol,seafood,grains,vegetables,beverages,eggs,
Henley Oâ€™Neill: confections,meat,grains,dairy,fats/oils,
Marcel Washington: eggs,alcohol,grains,
Valerie Waller: dairy,legumes/nuts/seeds,alcohol,fats/oils,eggs,confections,grains,
Marley Vaughn: confections,beverages,alcohol,legumes/nuts/seeds,meat,dairy,eggs,
Reign Griffin: legumes/nuts/seeds,grains,meat,fruit,alcohol,fats/oils,eggs,
Ayden Benjamin: eggs,seafood,beverages,vegetables,meat,fruit,
Jianna Copeland: dairy,alcohol,eggs,
Axton Brooks: fats/oils,dairy,confections,beverages,
Autumn Stark: legumes/nuts/seeds,seafood,beverages,vegetables,
Kristopher Buckley: legumes/nuts/seeds,fruit,seafood,vegetables,
Theodora Meyers: alcohol,legumes/nuts/seeds,meat,eggs,vegetables,
Julien Russo: fats/oils,eggs,fruit,legumes/nuts/seeds,alcohol,confections,seafood,
Tinsley Cantu: eggs,seafood,meat,alcohol,dairy,legumes/nuts/seeds,fats/oils,
Anakin Rocha: legumes/nuts/seeds,vegetables,dairy,
Emmie Weiss: fruit,seafood,grains,dairy,
Koa Anthony: seafood,eggs,dairy,legumes/nuts/seeds,alcohol,
Macy Hartman: fats/oils,legumes/nuts/seeds,eggs,dairy,fruit,grains,confections,
Baker Gutierrez: legumes/nuts/seeds,dairy,eggs,
Savannah Weiss: fats/oils,eggs,fruit,confections,vegetables,legumes/nuts/seeds,dairy,
Koa Richards: beverages,dairy,meat,fruit,alcohol,
Trinity Fields: fruit,dairy,grains,seafood,vegetables,confections,eggs,
Clayton Mercado: fruit,alcohol,beverages,fats/oils,meat,grains,legumes/nuts/seeds,
Mckinley Watts: fats/oils,fruit,seafood,meat,alcohol,legumes/nuts/seeds,
Dakota Patrick: fruit,alcohol,eggs,beverages,confections,seafood,meat,
Lyra Coleman: legumes/nuts/seeds,grains,confections,dairy,beverages,vegetables,eggs,
Micah George: grains,eggs,fruit,
Adelyn Rojas: alcohol,fats/oils,seafood,vegetables,
Colin Benton: beverages,vegetables,legumes/nuts/seeds,meat,seafood,grains,fats/oils,
Anais Estrada: legumes/nuts/seeds,eggs,seafood,beverages,meat,fruit,
Phoenix Houston: alcohol,vegetables,seafood,fruit,legumes/nuts/seeds,
Lylah Pham: dairy,fruit,grains,alcohol,
Russell Chase: legumes/nuts/seeds,grains,confections,
Angie West: grains,fruit,eggs,
Diego Nash: vegetables,grains,eggs,fruit,seafood,legumes/nuts/seeds,fats/oils,
Novah Dejesus: dairy,grains,legumes/nuts/seeds,beverages,alcohol,
Rio Henderson: alcohol,meat,dairy,
Maria Stokes: grains,meat,eggs,dairy,seafood,
Santana Lester: beverages,meat,dairy,
Averi Vang: fruit,vegetables,seafood,grains,legumes/nuts/seeds,meat,dairy,
Jimmy Middleton: meat,seafood,dairy,eggs,alcohol,fruit,beverages,
Madalyn Blair: meat,seafood,fats/oils,dairy,legumes/nuts/seeds,alcohol,eggs,
Troy Hunt: fats/oils,eggs,alcohol,beverages,
Genevieve Farley: eggs,beverages,fruit,alcohol,
Graysen Bradshaw: grains,fruit,legumes/nuts/seeds,eggs,vegetables,
Berkley Delacruz: grains,vegetables,alcohol,confections,meat,
Memphis Hunter: legumes/nuts/seeds,vegetables,fats/oils,eggs,
Khloe Villa: seafood,vegetables,eggs,fruit,
Clay Warner: confections,eggs,dairy,beverages,
Wynter Phelps: alcohol,legumes/nuts/seeds,fats/oils,dairy,confections,beverages,eggs,
Hamza Small: fats/oils,alcohol,eggs,confections,meat,legumes/nuts/seeds,
Zaria Lane: meat,fruit,eggs,vegetables,grains,beverages,seafood,
Matias Cortes: meat,alcohol,vegetables,seafood,fats/oils,beverages,
Lea Bennett: grains,eggs,beverages,meat,seafood,
Leonardo Patterson: beverages,grains,legumes/nuts/seeds,fruit,confections,seafood,
Kaylee Avery: vegetables,beverages,grains,confections,legumes/nuts/seeds,eggs,
Jakari Merritt: beverages,alcohol,meat,
Kaisley Conley: grains,fruit,fats/oils,legumes/nuts/seeds,seafood,beverages,confections,
Marvin Lyons: fruit,beverages,confections,
Kenzie Newman: meat,eggs,fruit,confections,
Anderson Elliott: legumes/nuts/seeds,grains,eggs,fruit,meat,fats/oils,
Noelle Meyers: grains,alcohol,dairy,
Julien Harrell: fats/oils,dairy,vegetables,grains,meat,alcohol,eggs,
Kara Villalobos: beverages,legumes/nuts/seeds,alcohol,fats/oils,grains,
Reuben McClure: fruit,vegetables,fats/oils,confections,seafood,meat,beverages,
Estella Fitzgerald: legumes/nuts/seeds,grains,meat,confections,beverages,seafood,
Peyton Morgan: fats/oils,vegetables,meat,eggs,confections,
Delilah Hodges: beverages,seafood,fruit,dairy,
Alonzo Todd: beverages,meat,alcohol,grains,seafood,dairy,
Zariah Compton: beverages,meat,confections,seafood,
Abner Marquez: confections,meat,seafood,fats/oils,fruit,grains,vegetables,
Milani Hansen: vegetables,fruit,alcohol,eggs,seafood,legumes/nuts/seeds,confections,
Charlie Haynes: confections,alcohol,meat,fruit,eggs,grains,dairy,
Lexi Duffy: alcohol,meat,beverages,eggs,fats/oils,seafood,confections,
Kyng Castaneda: grains,alcohol,dairy,vegetables,seafood,fruit,legumes/nuts/seeds,
Keira Bush: grains,alcohol,fruit,meat,
Tyson Campos: fruit,beverages,seafood,fats/oils,grains,legumes/nuts/seeds,dairy,
Sutton Lee: grains,seafood,eggs,
Jack Ellis: fruit,meat,confections,grains,
Ayla Stevenson: meat,legumes/nuts/seeds,vegetables,grains,fats/oils,
Callan Dennis: dairy,seafood,fats/oils,fruit,confections,
Maisie Vasquez: dairy,grains,fruit,vegetables,confections,fats/oils,eggs,
Rowan Navarro: fats/oils,legumes/nuts/seeds,confections,fruit,vegetables,eggs,beverages,
Winter Gibbs: seafood,fats/oils,grains,dairy,alcohol,
Deacon Daugherty: seafood,alcohol,meat,
Magdalena Houston: seafood,grains,fruit,alcohol,vegetables,dairy,confections,
Sylas Huerta: seafood,meat,dairy,fats/oils,
Dulce Vincent: grains,alcohol,meat,vegetables,legumes/nuts/seeds,dairy,fats/oils,
Aarav Bradshaw: fats/oils,confections,beverages,legumes/nuts/seeds,grains,eggs,
Berkley Mills: vegetables,fats/oils,eggs,dairy,
Alex Carr: fruit,beverages,vegetables,fats/oils,
Rowan Sosa: meat,eggs,fats/oils,legumes/nuts/seeds,vegetables,alcohol,grains,
Emir Wolfe: alcohol,fruit,meat,grains,seafood,beverages,vegetables,
Hallie Robbins: dairy,fruit,meat,seafood,
Finnegan Petersen: alcohol,seafood,beverages,meat,vegetables,
Fernanda Reynolds: fruit,confections,fats/oils,meat,grains,
Vincent Lim: legumes/nuts/seeds,fruit,beverages,fats/oils,confections,vegetables,
Giavanna Snow: legumes/nuts/seeds,eggs,grains,meat,fats/oils,
Houston Parra: fruit,confections,beverages,legumes/nuts/seeds,seafood,alcohol,grains,
Dalary Warner: legumes/nuts/seeds,alcohol,fats/oils,fruit,seafood,eggs,grains,
Jaxton Browning: dairy,legumes/nuts/seeds,fruit,beverages,fats/oils,alcohol,vegetables,
Princess Yu: legumes/nuts/seeds,alcohol,confections,grains,seafood,eggs,beverages,
Bryant Lawson: confections,fats/oils,alcohol,legumes/nuts/seeds,meat,eggs,beverages,
Phoebe Kirk: beverages,meat,alcohol,dairy,grains,seafood,vegetables,
Alessandro Roy: fruit,vegetables,dairy,legumes/nuts/seeds,meat,
Savanna Solomon: dairy,fruit,grains,
Musa Hardin: alcohol,vegetables,fruit,dairy,fats/oils,confections,
Vada Beard: fats/oils,seafood,fruit,eggs,dairy,beverages,
Nathanael Faulkner: seafood,fats/oils,vegetables,confections,alcohol,
Ansley Fuentes: eggs,dairy,fats/oils,seafood,grains,
Bowen Osborne: meat,legumes/nuts/seeds,confections,seafood,alcohol,
Shelby Boyd: meat,grains,eggs,beverages,seafood,confections,vegetables,
Dean Woodward: vegetables,eggs,alcohol,confections,fats/oils,seafood,beverages,
Drew Cisneros: legumes/nuts/seeds,fats/oils,dairy,seafood,confections,vegetables,
Alden Fletcher: alcohol,fats/oils,dairy,seafood,grains,fruit,
Anaya Douglas: dairy,seafood,alcohol,
Derek Lawrence: vegetables,alcohol,meat,dairy,confections,
Lauren Solomon: confections,legumes/nuts/seeds,grains,beverages,
Musa Walters: meat,confections,alcohol,eggs,
Samara Callahan: fruit,dairy,confections,grains,legumes/nuts/seeds,
Quinton Macdonald: vegetables,meat,seafood,
Rosalia Vazquez: legumes/nuts/seeds,dairy,grains,vegetables,
Jesse Stanton: vegetables,legumes/nuts/seeds,dairy,confections,eggs,fats/oils,grains,
Jaycee Wallace: confections,fruit,eggs,seafood,alcohol,beverages,fats/oils,
Chase Person: vegetables,beverages,fats/oils,fruit,alcohol,seafood,
Dylan Hill: legumes/nuts/seeds,seafood,fruit,fats/oils,alcohol,
Isaac Ashley: beverages,dairy,fruit,fats/oils,seafood,vegetables,alcohol,
Khalani Howard: alcohol,confections,fats/oils,eggs,dairy,grains,vegetables,
Jeremiah Serrano: dairy,beverages,seafood,alcohol,eggs,vegetables,grains,
Allie Hancock: fruit,vegetables,fats/oils,confections,beverages,
Rex Barber: dairy,vegetables,beverages,
Cassidy Lugo: fruit,seafood,grains,
Santos Tran: dairy,confections,fruit,alcohol,legumes/nuts/seeds,
Kylie Velasquez: seafood,legumes/nuts/seeds,eggs,alcohol,
Sullivan Burgess: legumes/nuts/seeds,alcohol,fruit,eggs,
Emory Brennan: eggs,dairy,seafood,confections,fats/oils,
Curtis Silva: legumes/nuts/seeds,confections,grains,alcohol,meat,seafood,
Lucia Lam: confections,eggs,seafood,
Bodie Maynard: grains,beverages,fats/oils,dairy,confections,
Carolyn Villanueva: alcohol,vegetables,fruit,eggs,confections,beverages,legumes/nuts/seeds,
Huxley Reilly: beverages,eggs,fruit,grains,fats/oils,vegetables,
Tori Quintero: meat,legumes/nuts/seeds,beverages,seafood,vegetables,eggs,confections,
Thatcher Mullins: seafood,meat,vegetables,legumes/nuts/seeds,
Maliyah Nicholson: beverages,fats/oils,dairy,eggs,
Rodrigo Truong: seafood,fruit,grains,beverages,legumes/nuts/seeds,fats/oils,eggs,
Judith Beard: vegetables,beverages,seafood,
Nathanael Ortiz: grains,seafood,fruit,
Anna Mueller: dairy,fats/oils,vegetables,
Albert Hancock: fats/oils,legumes/nuts/seeds,grains,
Katelyn Willis: alcohol,vegetables,dairy,fruit,meat,confections,
Remington Vang: meat,beverages,eggs,alcohol,grains,
Madisyn Spence: alcohol,fats/oils,beverages,meat,
Cillian Roberts: vegetables,meat,legumes/nuts/seeds,seafood,eggs,dairy,beverages,
Paisley Shepard: meat,vegetables,fruit,legumes/nuts/seeds,eggs,alcohol,
Damari Prince: alcohol,vegetables,eggs,dairy,fruit,grains,
Greta Weeks: eggs,beverages,confections,alcohol,
Anders Horn: vegetables,dairy,eggs,grains,legumes/nuts/seeds,beverages,
Avah Dalton: eggs,beverages,seafood,vegetables,
Fletcher Cortez: confections,vegetables,eggs,fats/oils,legumes/nuts/seeds,meat,dairy,
Haven Scott: fruit,beverages,grains,vegetables,fats/oils,alcohol,eggs,
Leo McDowell: eggs,alcohol,meat,vegetables,
Rayna Barrera: seafood,legumes/nuts/seeds,dairy,vegetables,
Makai Shields: eggs,beverages,meat,legumes/nuts/seeds,
Analia Wright: eggs,vegetables,beverages,alcohol,confections,grains,legumes/nuts/seeds,
Grayson Schultz: vegetables,fruit,dairy,beverages,
Briella Campos: fats/oils,alcohol,seafood,grains,fruit,beverages,
Gideon Perkins: vegetables,fats/oils,eggs,
Sage Griffin: beverages,confections,eggs,seafood,
Ayden Stevens: legumes/nuts/seeds,beverages,confections,alcohol,fruit,
Katherine Middleton: alcohol,dairy,vegetables,grains,fruit,seafood,
Misael Roy: seafood,legumes/nuts/seeds,beverages,alcohol,confections,fats/oils,grains,
Savanna Edwards: fruit,seafood,beverages,
Adrian Lamb: meat,beverages,dairy,grains,
Amaia Nunez: beverages,legumes/nuts/seeds,confections,meat,fats/oils,alcohol,fruit,
Caden Johnson: legumes/nuts/seeds,confections,fats/oils,alcohol,
Emma Roberson: beverages,alcohol,fruit,legumes/nuts/seeds,dairy,fats/oils,confections,
Shepherd Austin: beverages,fruit,vegetables,
Alivia Farmer: vegetables,eggs,seafood,grains,
Jamison Larsen: fruit,confections,vegetables,dairy,alcohol,
Xiomara Blair: dairy,meat,seafood,legumes/nuts/seeds,
Troy Jones: fruit,meat,eggs,fats/oils,seafood,confections,
Sophia Powers: seafood,fats/oils,grains,beverages,vegetables,confections,
Sean Rose: legumes/nuts/seeds,meat,seafood,eggs,confections,grains,fruit,
Magnolia Ballard: grains,vegetables,dairy,confections,
Kenzo Moreno: fruit,eggs,fats/oils,legumes/nuts/seeds,alcohol,meat,confections,
Mary Henson: alcohol,beverages,legumes/nuts/seeds,eggs,fats/oils,
Bellamy Buckley: dairy,meat,eggs,fruit,
Theodora Brown: alcohol,beverages,eggs,seafood,legumes/nuts/seeds,meat,
Elijah Prince: seafood,fats/oils,fruit,
Greta Mora: eggs,confections,dairy,legumes/nuts/seeds,alcohol,seafood,vegetables,
Arturo Parrish: dairy,beverages,fruit,fats/oils,seafood,meat,grains,
Tiana Massey: confections,fruit,grains,vegetables,meat,
Donald Calhoun: fats/oils,beverages,meat,confections,grains,seafood,alcohol,
Thalia Parsons: eggs,meat,beverages,confections,alcohol,vegetables,seafood,
Lewis Duke: vegetables,fruit,alcohol,dairy,grains,fats/oils,beverages,
Melani Espinosa: meat,legumes/nuts/seeds,seafood,confections,eggs,alcohol,fruit,
Khalid Schroeder: eggs,seafood,meat,dairy,
Cameron Hardin: confections,vegetables,eggs,fruit,beverages,legumes/nuts/seeds,dairy,
Hassan Stone: seafood,fats/oils,legumes/nuts/seeds,vegetables,fruit,grains,
Catalina Willis: vegetables,beverages,legumes/nuts/seeds,alcohol,confections,grains,fats/oils,
Remington Hunt: meat,legumes/nuts/seeds,vegetables,
Genevieve Williamson: fruit,vegetables,beverages,seafood,meat,grains,confections,
Emerson Pham: eggs,dairy,beverages,fruit,
Raelyn Gaines: fats/oils,eggs,alcohol,fruit,beverages,confections,meat,
Talon Monroe: beverages,vegetables,fats/oils,legumes/nuts/seeds,confections,
Carly Thornton: dairy,alcohol,seafood,eggs,fruit,
Malik Sanford: confections,fats/oils,seafood,eggs,grains,
Emerald Moreno: legumes/nuts/seeds,fruit,alcohol,
Myles Vang: seafood,confections,fruit,eggs,beverages,fats/oils,alcohol,
Madisyn Maddox: dairy,fruit,fats/oils,vegetables,legumes/nuts/seeds,alcohol,
Lyric Rasmussen: confections,fats/oils,vegetables,seafood,beverages,meat,legumes/nuts/seeds,
Esperanza Hester: meat,grains,confections,seafood,alcohol,legumes/nuts/seeds,
Rene Beasley: beverages,legumes/nuts/seeds,seafood,confections,vegetables,fats/oils,dairy,
Jaylah Rios: fruit,eggs,alcohol,fats/oils,confections,beverages,dairy,
Israel Marquez: seafood,fats/oils,alcohol,meat,beverages,eggs,
Milani Le: beverages,dairy,grains,confections,eggs,fruit,vegetables,
Damien Velazquez: fats/oils,fruit,vegetables,legumes/nuts/seeds,confections,grains,
Jaliyah Roberson: legumes/nuts/seeds,eggs,confections,meat,
Shepherd Simpson: dairy,seafood,fruit,vegetables,confections,
Anastasia Murphy: fruit,dairy,vegetables,meat,confections,seafood,
Cameron Barber: alcohol,grains,dairy,fats/oils,confections,beverages,legumes/nuts/seeds,
Cassidy Long: meat,seafood,vegetables,fats/oils,alcohol,dairy,grains,
Jace Wells: fruit,fats/oils,grains,
Cecilia Green: eggs,fats/oils,dairy,grains,
Anthony Hamilton: seafood,grains,fruit,alcohol,eggs,
Mackenzie Fischer: meat,confections,beverages,seafood,alcohol,vegetables,dairy,
Leonidas Acevedo: eggs,vegetables,meat,confections,fats/oils,seafood,grains,
Ashlynn Townsend: alcohol,fats/oils,confections,grains,vegetables,
Alexis Hodge: fruit,vegetables,fats/oils,alcohol,beverages,
Coraline Bernal: vegetables,confections,alcohol,dairy,
Eithan Curtis: confections,beverages,eggs,legumes/nuts/seeds,grains,fruit,vegetables,
Alexis Archer: meat,eggs,vegetables,fruit,dairy,confections,
Ephraim Boyd: grains,dairy,fruit,vegetables,meat,fats/oils,confections,
Georgia Melton: beverages,eggs,alcohol,
Lennon Byrd: fruit,meat,seafood,fats/oils,
Giselle Hudson: grains,beverages,legumes/nuts/seeds,fruit,meat,
Peter Martin: meat,seafood,fats/oils,
Mila Khan: grains,fruit,legumes/nuts/seeds,eggs,fats/oils,seafood,beverages,
Kendrick Singh: seafood,vegetables,grains,
Vivienne Schwartz: meat,legumes/nuts/seeds,fruit,alcohol,
Edwin Pennington: vegetables,fats/oils,dairy,fruit,legumes/nuts/seeds,beverages,
Yareli Dawson: beverages,legumes/nuts/seeds,fats/oils,grains,seafood,fruit,
Iker Barry: fats/oils,fruit,dairy,beverages,eggs,grains,alcohol,
Waverly Mathews: meat,seafood,confections,eggs,
Jamir Jacobs: beverages,alcohol,eggs,
Camilla Moyer: fruit,seafood,legumes/nuts/seeds,grains,confections,fats/oils,
Ahmir Martinez: dairy,fruit,eggs,
Harper Garcia: grains,alcohol,confections,
James Frost: fats/oils,meat,eggs,legumes/nuts/seeds,seafood,alcohol,
Paula Hall: legumes/nuts/seeds,meat,confections,dairy,
Thomas Hale: fats/oils,confections,meat,legumes/nuts/seeds,alcohol,fruit,
Brinley Carr: meat,seafood,fats/oils,legumes/nuts/seeds,alcohol,grains,beverages,
Kash Palmer: eggs,fruit,beverages,dairy,
Juniper Henderson: fruit,confections,seafood,fats/oils,
Beau Guevara: dairy,fats/oils,alcohol,
Teresa Li: vegetables,fats/oils,legumes/nuts/seeds,grains,beverages,fruit,alcohol,
Jorge Watkins: seafood,meat,grains,alcohol,fats/oils,fruit,legumes/nuts/seeds,
Lola Terrell: grains,fruit,alcohol,confections,seafood,beverages,
Jaxen Cordova: alcohol,beverages,dairy,grains,
Florence Harrison: confections,dairy,seafood,meat,legumes/nuts/seeds,eggs,
Gavin Bullock: fruit,beverages,legumes/nuts/seeds,confections,meat,grains,
Winnie Pitts: grains,confections,meat,vegetables,legumes/nuts/seeds,
Trey Richmond: meat,dairy,seafood,confections,fats/oils,grains,eggs,
Whitney Wallace: confections,meat,seafood,
Chase Buck: vegetables,seafood,legumes/nuts/seeds,alcohol,fats/oils,beverages,dairy,
Livia Benjamin: fats/oils,eggs,dairy,confections,
Kyro Correa: fats/oils,beverages,dairy,fruit,
Valery Peralta: legumes/nuts/seeds,eggs,alcohol,confections,seafood,beverages,
Dangelo Bridges: fruit,grains,meat,beverages,
Elora May: fats/oils,eggs,meat,
Finley Vasquez: confections,fruit,seafood,fats/oils,vegetables,alcohol,
Rose Copeland: meat,fats/oils,alcohol,seafood,beverages,eggs,vegetables,
Axton Gibson: grains,eggs,meat,confections,
Eden Manning: fats/oils,alcohol,seafood,beverages,fruit,eggs,
Seth Henry: eggs,alcohol,seafood,confections,meat,
Summer Mills: fruit,alcohol,seafood,fats/oils,
Alex Stewart: vegetables,legumes/nuts/seeds,grains,confections,fats/oils,seafood,
Maya Leach: eggs,fruit,confections,fats/oils,
Westin Marin: fruit,confections,dairy,grains,
Celia Newton: grains,eggs,meat,
Santino Gould: grains,dairy,beverages,seafood,legumes/nuts/seeds,vegetables,
Violeta McCullough: grains,legumes/nuts/seeds,alcohol,
Briar Rhodes: meat,legumes/nuts/seeds,fats/oils,grains,seafood,eggs,confections,
Tatum Hanson: fats/oils,dairy,grains,
Khalil Davidson: grains,meat,fats/oils,confections,eggs,vegetables,
Jayla Price: dairy,fruit,fats/oils,vegetables,grains,meat,
Brooks Calhoun: fats/oils,beverages,alcohol,confections,vegetables,
Thalia Cano: seafood,fruit,meat,
Terry Acevedo: grains,eggs,alcohol,
Ashlynn Merritt: grains,legumes/nuts/seeds,eggs,fruit,alcohol,
Colten Martinez: seafood,vegetables,confections,fruit,
Harper Lyons: vegetables,seafood,legumes/nuts/seeds,beverages,dairy,alcohol,
Cyrus Davila: alcohol,meat,fruit,beverages,
Rayne Campbell: beverages,fats/oils,seafood,vegetables,fruit,
Christopher Velasquez: seafood,alcohol,beverages,confections,legumes/nuts/seeds,fats/oils,
Esme Adams: dairy,seafood,legumes/nuts/seeds,fruit,
Hudson Daniel: alcohol,fruit,beverages,confections,vegetables,fats/oils,
Joy Wilkerson: alcohol,seafood,beverages,fats/oils,meat,legumes/nuts/seeds,
Carmelo Shah: grains,fruit,alcohol,seafood,beverages,
Angelica Abbott: legumes/nuts/seeds,fats/oils,dairy,
Kohen Sexton: vegetables,seafood,alcohol,
Ellen Riley: legumes/nuts/seeds,seafood,eggs,fats/oils,grains,dairy,confections,
Amari McIntosh: legumes/nuts/seeds,seafood,meat,
Gwen Odom: vegetables,meat,eggs,beverages,confections,
Kylian Tate: meat,seafood,confections,fats/oils,
Skye Delacruz: dairy,grains,beverages,confections,fruit,legumes/nuts/seeds,fats/oils,
Memphis Moses: beverages,legumes/nuts/seeds,eggs,
Karter Stuart: grains,eggs,alcohol,beverages,seafood,
Dion Scott: fruit,confections,fats/oils,
Aurora Mora: grains,vegetables,eggs,confections,meat,
Arturo Lyons: fats/oils,vegetables,meat,confections,grains,seafood,beverages,
Kenzie Cain: dairy,fruit,alcohol,seafood,vegetables,legumes/nuts/seeds,confections,
Benson Dickson: seafood,vegetables,alcohol,
Emmalynn Duke: grains,meat,dairy,alcohol,legumes/nuts/seeds,fruit,
Kalel Andersen: fruit,alcohol,grains,beverages,
Zoie Kent: grains,meat,seafood,fruit,alcohol,confections,beverages,
Mekhi Newton: meat,seafood,beverages,
Braelynn Knapp: fats/oils,eggs,alcohol,dairy,beverages,fruit,seafood,
Boden Lucero: fats/oils,vegetables,confections,dairy,meat,seafood,
Ila King: vegetables,confections,alcohol,fats/oils,eggs,beverages,
Julian Herring: confections,meat,fruit,vegetables,beverages,
Denver Fleming: fats/oils,seafood,legumes/nuts/seeds,grains,eggs,beverages,fruit,
Fernando Kennedy: confections,beverages,fats/oils,seafood,vegetables,grains,eggs,
Brianna Crosby: grains,meat,vegetables,alcohol,beverages,confections,legumes/nuts/seeds,
Tristen Leach: fats/oils,meat,alcohol,legumes/nuts/seeds,vegetables,seafood,beverages,
Martha Parsons: fruit,fats/oils,dairy,seafood,alcohol,confections,meat,
Lewis Moyer: vegetables,legumes/nuts/seeds,dairy,meat,grains,
Zola Snow: confections,grains,seafood,beverages,meat,legumes/nuts/seeds,alcohol,
Houston Green: beverages,grains,seafood,legumes/nuts/seeds,
Zoe Rice: seafood,fats/oils,meat,
Graham McCormick: seafood,dairy,meat,
Macie Harrell: legumes/nuts/seeds,fats/oils,eggs,
Nelson Whitaker: vegetables,beverages,eggs,meat,fruit,fats/oils,grains,
Ivanna Douglas: eggs,confections,fats/oils,dairy,fruit,beverages,
Derek Powers: fats/oils,fruit,meat,grains,
Michelle Wise: vegetables,meat,fruit,seafood,
Frederick Rios: fats/oils,legumes/nuts/seeds,fruit,grains,seafood,dairy,confections,
Brooke Winters: vegetables,fruit,legumes/nuts/seeds,eggs,seafood,alcohol,
Deandre Tate: fats/oils,alcohol,meat,
Skye Walton: alcohol,beverages,legumes/nuts/seeds,
Dominick Walsh: fats/oils,fruit,beverages,dairy,grains,seafood,vegetables,
Leia Turner: grains,seafood,beverages,legumes/nuts/seeds,
Joshua Russell: grains,seafood,legumes/nuts/seeds,beverages,vegetables,eggs,fruit,
Raelynn Oliver: eggs,seafood,legumes/nuts/seeds,alcohol,vegetables,fruit,grains,
Karson Pugh: meat,fats/oils,beverages,grains,eggs,dairy,
Landry Medina: grains,seafood,meat,eggs,fruit,
George Alvarez: alcohol,grains,seafood,dairy,
Leilani Jackson: fruit,fats/oils,seafood,meat,
Sebastian Cherry: beverages,seafood,eggs,fruit,confections,fats/oils,
Nyomi Sims: grains,beverages,eggs,seafood,alcohol,fruit,
Brian Pope: vegetables,dairy,confections,beverages,
Aurelia Liu: alcohol,grains,legumes/nuts/seeds,
Pedro Butler: seafood,dairy,fruit,confections,alcohol,meat,
Athena Orozco: eggs,beverages,fats/oils,fruit,dairy,grains,legumes/nuts/seeds,
Keanu Hebert: vegetables,seafood,alcohol,legumes/nuts/seeds,
Kyleigh Welch: seafood,vegetables,meat,alcohol,beverages,eggs,dairy,
Hendrix Kirk: meat,legumes/nuts/seeds,eggs,
Ellis Walsh: dairy,legumes/nuts/seeds,eggs,fats/oils,
Bodhi Conley: grains,seafood,beverages,meat,legumes/nuts/seeds,
Salem Jaramillo: meat,fats/oils,fruit,
Riggs Vaughan: confections,grains,meat,legumes/nuts/seeds,
Nancy Ventura: fats/oils,vegetables,seafood,grains,fruit,meat,alcohol,
Branson Stark: eggs,vegetables,meat,confections,legumes/nuts/seeds,
Kamilah Santos: legumes/nuts/seeds,beverages,alcohol,vegetables,fruit,eggs,fats/oils,
Walker Wilkerson: beverages,legumes/nuts/seeds,dairy,grains,meat,fats/oils,vegetables,
Janiyah Dorsey: confections,eggs,beverages,
Enoch Medina: seafood,eggs,grains,confections,fruit,dairy,
Elliana Alvarado: alcohol,dairy,legumes/nuts/seeds,confections,fruit,grains,
Andres Adkins: alcohol,grains,dairy,
Emelia Oâ€™Connell: fats/oils,seafood,fruit,
Jovanni Webb: vegetables,beverages,confections,fats/oils,
Ariella Maldonado: confections,eggs,alcohol,legumes/nuts/seeds,fats/oils,seafood,
Javier Cobb: beverages,vegetables,eggs,meat,
Aviana Fry: dairy,legumes/nuts/seeds,meat,grains,seafood,confections,vegetables,
Jacoby Manning: dairy,fats/oils,legumes/nuts/seeds,vegetables,
Jennifer Jackson: fruit,fats/oils,meat,
Sebastian Shah: alcohol,eggs,seafood,
Angelica Morales: vegetables,meat,confections,
Aaron Rojas: meat,confections,grains,
Adaline Ballard: eggs,seafood,grains,
Kenzo Ferguson: eggs,beverages,confections,alcohol,legumes/nuts/seeds,meat,fruit,
Juliana Mack: legumes/nuts/seeds,beverages,grains,meat,dairy,eggs,
Esteban Hebert: legumes/nuts/seeds,fats/oils,dairy,grains,alcohol,meat,fruit,
Kyleigh Garrett: legumes/nuts/seeds,fats/oils,eggs,beverages,alcohol,grains,fruit,
Kairo Cisneros: dairy,confections,seafood,grains,eggs,
Janelle Lawrence: eggs,dairy,fruit,grains,vegetables,meat,
Kaleb Petersen: fruit,eggs,dairy,confections,seafood,fats/oils,alcohol,
Fernanda Rivera: fruit,legumes/nuts/seeds,grains,
Charles Ross: confections,eggs,seafood,dairy,beverages,fats/oils,legumes/nuts/seeds,
Peyton Hobbs: fats/oils,dairy,confections,beverages,seafood,
Brendan Willis: fruit,vegetables,eggs,
Alexa Monroe: alcohol,vegetables,eggs,confections,
Colby Johns: seafood,legumes/nuts/seeds,confections,grains,eggs,dairy,fruit,
Giovanna McLaughlin: alcohol,legumes/nuts/seeds,vegetables,grains,
Ibrahim Acevedo: fats/oils,grains,beverages,
Ashlynn Espinosa: grains,confections,dairy,seafood,alcohol,vegetables,legumes/nuts/seeds,
Khalid Barrett: beverages,eggs,legumes/nuts/seeds,fruit,confections,fats/oils,meat,
Kendall Lang: alcohol,seafood,legumes/nuts/seeds,beverages,fruit,
Wells Fernandez: grains,alcohol,vegetables,eggs,legumes/nuts/seeds,meat,beverages,
Amara McKenzie: dairy,legumes/nuts/seeds,fruit,grains,confections,
Scott Waters: eggs,confections,vegetables,fats/oils,dairy,legumes/nuts/seeds,beverages,
Bristol Prince: vegetables,legumes/nuts/seeds,alcohol,
Aron Garcia: beverages,dairy,fats/oils,fruit,confections,legumes/nuts/seeds,
Amelia Stevenson: dairy,alcohol,confections,vegetables,
Callan McClain: confections,fats/oils,eggs,fruit,vegetables,alcohol,grains,
Marleigh Frost: grains,fats/oils,seafood,meat,
Dario Harding: fruit,dairy,seafood,
Aniya Pennington: seafood,fruit,alcohol,legumes/nuts/seeds,beverages,confections,
Bobby Williams: beverages,fats/oils,confections,
Ava Banks: fats/oils,legumes/nuts/seeds,fruit,dairy,confections,grains,meat,
Martin Singleton: fruit,meat,vegetables,
Malaysia Gonzalez: beverages,grains,confections,fruit,dairy,
Ethan Martin: alcohol,beverages,eggs,
Mila Serrano: seafood,fats/oils,eggs,
Milan Leach: meat,alcohol,beverages,dairy,grains,fruit,
Martha Quintero: vegetables,meat,fruit,legumes/nuts/seeds,
Thatcher Huynh: grains,fruit,dairy,fats/oils,legumes/nuts/seeds,seafood,alcohol,
Oaklee Savage: legumes/nuts/seeds,seafood,fats/oils,meat,
Keaton Bond: confections,alcohol,meat,beverages,
Alena Sexton: seafood,vegetables,beverages,confections,legumes/nuts/seeds,
Mylo Perez: vegetables,dairy,eggs,fruit,seafood,legumes/nuts/seeds,alcohol,
Eleanor Hood: meat,fruit,confections,dairy,eggs,legumes/nuts/seeds,
Brixton Strong: grains,dairy,seafood,legumes/nuts/seeds,beverages,
Margo Wyatt: seafood,eggs,fats/oils,beverages,meat,fruit,
Sam Stanton: alcohol,dairy,legumes/nuts/seeds,eggs,seafood,grains,
Jaycee Arellano: eggs,fruit,seafood,fats/oils,grains,beverages,meat,
Kellan Lara: beverages,fats/oils,confections,seafood,
Heidi Blackwell: fruit,eggs,grains,confections,
Marcellus Cortes: legumes/nuts/seeds,dairy,fats/oils,seafood,beverages,grains,
Lea Cortez: seafood,dairy,beverages,vegetables,
Zayn Bauer: fruit,vegetables,grains,confections,
Haley Hubbard: grains,fats/oils,dairy,confections,beverages,legumes/nuts/seeds,alcohol,
Forrest McDowell: confections,legumes/nuts/seeds,dairy,
Rayna Jensen: beverages,legumes/nuts/seeds,grains,
Cash Dejesus: grains,eggs,seafood,beverages,meat,alcohol,vegetables,
Julissa Hardin: confections,beverages,fruit,alcohol,meat,vegetables,
Hassan Lowe: seafood,legumes/nuts/seeds,beverages,fruit,vegetables,fats/oils,eggs,
Amari Brock: vegetables,legumes/nuts/seeds,fruit,alcohol,
Julio Stafford: confections,grains,alcohol,beverages,legumes/nuts/seeds,meat,dairy,
Bridget Austin: seafood,meat,alcohol,legumes/nuts/seeds,dairy,confections,
Omar Flowers: eggs,dairy,seafood,grains,legumes/nuts/seeds,beverages,confections,
Ariya Carr: meat,legumes/nuts/seeds,alcohol,
Kash Jackson: seafood,legumes/nuts/seeds,meat,fruit,
Avery Warren: seafood,vegetables,fruit,beverages,dairy,legumes/nuts/seeds,fats/oils,
Abel Stark: legumes/nuts/seeds,fats/oils,beverages,dairy,
Kamilah Leon: grains,alcohol,fruit,confections,dairy,seafood,
Marshall Weiss: legumes/nuts/seeds,grains,vegetables,eggs,beverages,seafood,alcohol,
Lennox Long: seafood,vegetables,alcohol,fats/oils,meat,
Jace Lim: fats/oils,vegetables,confections,dairy,meat,
Giavanna Pollard: vegetables,fruit,dairy,seafood,beverages,eggs,
Jad Ayala: eggs,beverages,grains,legumes/nuts/seeds,vegetables,
Blair Fletcher: confections,fats/oils,seafood,grains,vegetables,meat,legumes/nuts/seeds,
Jay House: eggs,dairy,legumes/nuts/seeds,fruit,grains,beverages,confections,
Sariah Moon: eggs,fats/oils,confections,grains,meat,legumes/nuts/seeds,seafood,
Nova Mata: beverages,seafood,vegetables,alcohol,
Lillie Grant: seafood,alcohol,legumes/nuts/seeds,fruit,beverages,
Leon Maddox: grains,dairy,beverages,meat,legumes/nuts/seeds,confections,fats/oils,
Zainab Archer: confections,vegetables,legumes/nuts/seeds,
Ephraim Figueroa: beverages,fats/oils,eggs,grains,vegetables,alcohol,
Lilith Hess: fats/oils,eggs,vegetables,meat,grains,
Lawrence Alvarado: beverages,dairy,alcohol,fruit,vegetables,
Blake Jacobson: dairy,confections,vegetables,beverages,grains,fats/oils,seafood,
Legacy Barber: fruit,eggs,beverages,alcohol,
Cassidy Munoz: confections,vegetables,dairy,legumes/nuts/seeds,beverages,alcohol,
Justin Perkins: legumes/nuts/seeds,seafood,confections,alcohol,vegetables,beverages,fruit,
Sage Medrano: fruit,fats/oils,eggs,confections,vegetables,beverages,
Arian Hunter: alcohol,seafood,fruit,dairy,
Khloe Bernal: beverages,meat,vegetables,eggs,fruit,fats/oils,seafood,
Eithan Mora: legumes/nuts/seeds,dairy,fruit,grains,meat,fats/oils,
Jemma Norton: fats/oils,eggs,seafood,grains,meat,legumes/nuts/seeds,
Callen Page: dairy,confections,grains,alcohol,vegetables,
Cataleya Marquez: eggs,fruit,alcohol,seafood,dairy,legumes/nuts/seeds,
Malakai Palmer: grains,alcohol,beverages,fats/oils,
Juniper Graham: vegetables,fruit,confections,seafood,alcohol,eggs,
Giovanni Blevins: alcohol,confections,meat,vegetables,legumes/nuts/seeds,grains,
Aila Todd: vegetables,dairy,grains,seafood,fruit,confections,
Baylor Solis: alcohol,eggs,legumes/nuts/seeds,
Miracle Davenport: eggs,fruit,fats/oils,
Dariel Perkins: beverages,dairy,legumes/nuts/seeds,
Sage Palmer: vegetables,seafood,dairy,fats/oils,confections,meat,fruit,
Theo Lozano: beverages,legumes/nuts/seeds,vegetables,dairy,seafood,fats/oils,fruit,
Cecelia Butler: fruit,beverages,legumes/nuts/seeds,
Ryder Mason: eggs,confections,alcohol,beverages,
Sienna Beasley: seafood,confections,grains,vegetables,beverages,dairy,
Stanley McCarty: seafood,beverages,vegetables,fats/oils,meat,dairy,confections,
Halo Harris: confections,meat,beverages,legumes/nuts/seeds,grains,fats/oils,
Samuel Vincent: eggs,dairy,meat,grains,seafood,
Allyson Chavez: fats/oils,fruit,beverages,alcohol,
Ian Jensen: fats/oils,dairy,fruit,
Jane Clarke: dairy,meat,grains,fruit,beverages,fats/oils,
Stetson Charles: fruit,legumes/nuts/seeds,dairy,vegetables,beverages,grains,seafood,
Jenna Morrison: fats/oils,confections,meat,legumes/nuts/seeds,grains,eggs,
Maximus Newton: alcohol,fruit,grains,seafood,
Braelynn Cobb: seafood,fruit,meat,vegetables,beverages,alcohol,
Raphael Lim: fats/oils,alcohol,fruit,legumes/nuts/seeds,vegetables,beverages,seafood,
Giavanna Hahn: vegetables,alcohol,beverages,
Kabir Vo: beverages,grains,seafood,alcohol,fats/oils,dairy,confections,
Artemis Shepard: fruit,beverages,vegetables,dairy,
Damari Winters: legumes/nuts/seeds,seafood,meat,eggs,dairy,fats/oils,
Kataleya Sawyer: dairy,eggs,fats/oils,grains,seafood,beverages,meat,
Jefferson Bradford: legumes/nuts/seeds,meat,seafood,fruit,eggs,
Rhea Solomon: grains,fruit,vegetables,legumes/nuts/seeds,beverages,
Musa Esquivel: beverages,meat,legumes/nuts/seeds,fruit,alcohol,fats/oils,seafood,
Jaylee Winters: seafood,alcohol,confections,fats/oils,
Deandre Blanchard: meat,legumes/nuts/seeds,alcohol,grains,seafood,dairy,
Layne Stokes: beverages,dairy,eggs,meat,seafood,vegetables,grains,
Santana Nelson: dairy,legumes/nuts/seeds,fruit,fats/oils,eggs,beverages,
Everly Ahmed: fruit,eggs,beverages,confections,seafood,alcohol,meat,
Harry Perry: fruit,dairy,fats/oils,
Clara Heath: seafood,alcohol,beverages,
Lionel Rubio: beverages,legumes/nuts/seeds,fruit,fats/oils,eggs,grains,
Hadassah Adkins: alcohol,seafood,fats/oils,dairy,eggs,grains,legumes/nuts/seeds,
Kylo Cannon: vegetables,grains,legumes/nuts/seeds,
Noa Kirby: dairy,seafood,eggs,confections,
Tony Terry: meat,fats/oils,grains,confections,legumes/nuts/seeds,dairy,
Wren Marshall: fats/oils,confections,dairy,legumes/nuts/seeds,vegetables,beverages,meat,
Kaiden Sawyer: grains,vegetables,confections,eggs,beverages,meat,
Marina Hart: confections,grains,seafood,vegetables,
Joel Leal: beverages,alcohol,legumes/nuts/seeds,grains,fruit,confections,fats/oils,
Murphy Spencer: meat,vegetables,confections,legumes/nuts/seeds,seafood,fats/oils,beverages,
Ace Beil: legumes/nuts/seeds,alcohol,beverages,
Itzel Whitehead: meat,beverages,seafood,confections,fruit,grains,eggs,
Zayd Lucas: alcohol,fruit,vegetables,seafood,meat,legumes/nuts/seeds,
Phoenix Molina: vegetables,dairy,eggs,fruit,
Prince Melton: eggs,legumes/nuts/seeds,fruit,dairy,confections,alcohol,
Kamiyah Myers: vegetables,fruit,legumes/nuts/seeds,beverages,confections,grains,
Adam Grant: confections,alcohol,meat,
Alaina Ramsey: meat,vegetables,dairy,fruit,grains,
Luciano Donovan: fruit,dairy,seafood,meat,confections,eggs,alcohol,
Azariah Peralta: meat,vegetables,grains,beverages,fruit,legumes/nuts/seeds,
Dangelo Alvarado: eggs,beverages,legumes/nuts/seeds,meat,seafood,
Blake Bernal: beverages,seafood,alcohol,meat,eggs,vegetables,
Eithan Long: meat,legumes/nuts/seeds,confections,
Jade Nichols: seafood,vegetables,fats/oils,beverages,
Atlas Crawford: dairy,fruit,alcohol,confections,
Aubree Stein: eggs,dairy,seafood,
Creed Hebert: meat,vegetables,fats/oils,alcohol,fruit,seafood,
Kyleigh Ayers: seafood,grains,eggs,
Ulises Gentry: seafood,fruit,legumes/nuts/seeds,
Amelie Burnett: legumes/nuts/seeds,alcohol,eggs,fats/oils,meat,beverages,vegetables,
Davis Diaz: meat,alcohol,confections,beverages,eggs,
Elena Torres: eggs,seafood,fruit,beverages,
Jayden Jordan: alcohol,fats/oils,meat,beverages,eggs,fruit,confections,
Adalynn Spence: alcohol,fruit,eggs,dairy,
Cillian Bush: fruit,meat,confections,
Everlee Tanner: vegetables,seafood,fruit,meat,alcohol,
Bruno Hickman: eggs,dairy,seafood,grains,confections,
Scarlette Noble: fruit,fats/oils,meat,seafood,legumes/nuts/seeds,beverages,dairy,
Idris Singleton: seafood,meat,alcohol,vegetables,beverages,fruit,confections,
Malaysia Crosby: seafood,meat,eggs,dairy,
Tristen Bowers: grains,eggs,fruit,alcohol,legumes/nuts/seeds,seafood,
Elisa Watson: eggs,fats/oils,fruit,beverages,confections,dairy,seafood,
Greyson McMillan: eggs,fats/oils,vegetables,confections,seafood,
Oakleigh Beard: meat,alcohol,seafood,
Nathanael Warner: fruit,legumes/nuts/seeds,dairy,meat,eggs,grains,
Wynter Atkinson: alcohol,meat,grains,fats/oils,eggs,
Duke Hendricks: seafood,vegetables,grains,dairy,fats/oils,
Dani Burton: legumes/nuts/seeds,beverages,alcohol,
Zander McCarty: alcohol,vegetables,beverages,legumes/nuts/seeds,dairy,
Halo Bennett: beverages,legumes/nuts/seeds,seafood,fruit,
Leonardo Flynn: beverages,grains,meat,vegetables,dairy,fruit,
Dorothy Meadows: fruit,eggs,grains,confections,alcohol,
Wayne Lambert: fruit,beverages,dairy,grains,confections,legumes/nuts/seeds,alcohol,
Nina Maynard: fruit,grains,alcohol,seafood,eggs,vegetables,
Landry Kent: eggs,confections,legumes/nuts/seeds,seafood,meat,alcohol,
Jazmine Harrington: dairy,fats/oils,confections,alcohol,vegetables,
Omari Hudson: fats/oils,dairy,meat,fruit,
Kamila Rose: vegetables,meat,fats/oils,alcohol,dairy,
Hayden Pace: beverages,dairy,meat,fruit,alcohol,grains,
Giana Cannon: fats/oils,meat,seafood,alcohol,confections,eggs,
Archie Flynn: alcohol,eggs,seafood,
Dorothy Maldonado: vegetables,beverages,grains,seafood,dairy,alcohol,meat,
Javier Dawson: eggs,vegetables,fats/oils,seafood,
Veronica Baker: alcohol,seafood,dairy,vegetables,eggs,fruit,confections,
Ezra Maddox: confections,eggs,seafood,beverages,grains,alcohol,
Zainab Banks: beverages,vegetables,meat,seafood,eggs,confections,fruit,
Martin Vincent: meat,dairy,legumes/nuts/seeds,seafood,fats/oils,grains,
Allyson Bowen: dairy,eggs,fruit,fats/oils,confections,vegetables,
Trevor Powell: vegetables,seafood,meat,
Vivian Morrow: fruit,seafood,meat,grains,eggs,
Kyree Ali: beverages,alcohol,seafood,grains,
Zelda Ray: alcohol,meat,fruit,fats/oils,confections,grains,vegetables,
Arlo Nicholson: fats/oils,legumes/nuts/seeds,seafood,eggs,meat,alcohol,
Justice Pugh: seafood,grains,eggs,alcohol,fats/oils,beverages,confections,
Judson Kaur: vegetables,confections,fruit,
Holland Barr: fats/oils,dairy,seafood,
Harley Singh: meat,alcohol,dairy,eggs,vegetables,
Vivienne Jefferson: alcohol,seafood,fruit,
Raylan Lang: legumes/nuts/seeds,alcohol,vegetables,fats/oils,meat,eggs,grains,
Amirah Barron: confections,fats/oils,dairy,
Dustin Branch: legumes/nuts/seeds,meat,grains,
Luisa Contreras: fats/oils,confections,meat,alcohol,eggs,beverages,
Emilio Copeland: beverages,fruit,seafood,
Dayana McGee: alcohol,beverages,meat,grains,legumes/nuts/seeds,
Conner Boyer: dairy,alcohol,vegetables,seafood,confections,fruit,
Chaya Stanton: confections,grains,alcohol,fruit,fats/oils,seafood,
Zyair Barry: alcohol,eggs,confections,legumes/nuts/seeds,grains,dairy,vegetables,
Waverly Ford: meat,fats/oils,alcohol,seafood,legumes/nuts/seeds,dairy,
Luis Montoya: dairy,vegetables,grains,alcohol,confections,
Kamryn Gill: fruit,alcohol,meat,seafood,
Matthias Dyer: meat,dairy,grains,fruit,beverages,legumes/nuts/seeds,
Estrella Frazier: seafood,beverages,vegetables,confections,legumes/nuts/seeds,
Callum Blanchard: legumes/nuts/seeds,vegetables,fats/oils,
Layne Reed: eggs,confections,dairy,grains,
Easton Villegas: beverages,seafood,eggs,fruit,fats/oils,vegetables,grains,
Jessie Patton: alcohol,grains,vegetables,confections,legumes/nuts/seeds,meat,
Moises Acosta: beverages,vegetables,fruit,grains,confections,alcohol,fats/oils,
Kaia Berger: seafood,beverages,legumes/nuts/seeds,
Byron Lyons: eggs,confections,vegetables,grains,legumes/nuts/seeds,fats/oils,meat,
Kenzie Buck: seafood,legumes/nuts/seeds,confections,vegetables,grains,dairy,fats/oils,
Jon McConnell: meat,fats/oils,grains,legumes/nuts/seeds,vegetables,alcohol,
Denise Middleton: meat,legumes/nuts/seeds,dairy,alcohol,
Misael Cano: legumes/nuts/seeds,meat,dairy,fats/oils,eggs,alcohol,fruit,
Egypt Ingram: grains,meat,eggs,alcohol,
Tripp Pugh: dairy,fats/oils,vegetables,beverages,
Landry Bowen: grains,fats/oils,dairy,beverages,seafood,eggs,
Trevor Wilcox: dairy,fruit,confections,eggs,legumes/nuts/seeds,
Ashlyn Mejia: fruit,legumes/nuts/seeds,confections,meat,beverages,dairy,alcohol,
Atticus Wilkinson: alcohol,grains,seafood,eggs,legumes/nuts/seeds,
Siena Norton: grains,confections,meat,eggs,vegetables,legumes/nuts/seeds,alcohol,
Callen Powell: fruit,confections,beverages,
Vivian Oâ€™Donnell: alcohol,confections,seafood,
Lian Rodriguez: meat,fats/oils,fruit,dairy,seafood,
Evelyn Flynn: grains,confections,dairy,fruit,fats/oils,legumes/nuts/seeds,meat,
Kannon McCullough: alcohol,confections,legumes/nuts/seeds,dairy,eggs,vegetables,
Hana Cobb: grains,beverages,fruit,fats/oils,
Raphael Cruz: fruit,eggs,grains,confections,fats/oils,
Claire Parrish: fats/oils,grains,beverages,fruit,
Karsyn Golden: seafood,beverages,alcohol,legumes/nuts/seeds,eggs,confections,
Giuliana Hogan: meat,grains,dairy,confections,
Sonny Barajas: dairy,beverages,legumes/nuts/seeds,confections,
Keilani Simon: dairy,grains,seafood,beverages,fats/oils,meat,alcohol,
Zayne Blankenship: confections,eggs,dairy,
Rosalee Costa: meat,eggs,fruit,confections,
Kenji Burch: meat,grains,confections,eggs,seafood,vegetables,fats/oils,
Freyja Benton: confections,seafood,eggs,
Jamal Foley: fruit,meat,confections,legumes/nuts/seeds,grains,seafood,dairy,
Zaylee Luna: meat,grains,dairy,
Erick Mora: beverages,confections,legumes/nuts/seeds,alcohol,fats/oils,eggs,
Jemma Raymond: alcohol,grains,fats/oils,
Maurice Noble: eggs,confections,legumes/nuts/seeds,fruit,vegetables,dairy,
Hunter Christian: dairy,alcohol,seafood,fruit,beverages,confections,eggs,
Ledger Long: legumes/nuts/seeds,fats/oils,grains,confections,beverages,dairy,
Jade Spencer: fruit,eggs,confections,
Ace Rivas: fats/oils,dairy,beverages,fruit,seafood,
Averie Pearson: fruit,confections,dairy,meat,
Gunner Figueroa: seafood,dairy,fruit,beverages,alcohol,
Lilith Bishop: seafood,confections,beverages,grains,
Paxton Huff: beverages,meat,confections,fruit,seafood,dairy,
Karsyn Hester: legumes/nuts/seeds,seafood,eggs,fruit,fats/oils,
Rene Bryant: alcohol,vegetables,dairy,beverages,fruit,seafood,
Parker Rojas: confections,alcohol,eggs,dairy,seafood,fruit,meat,
Colin Gross: confections,beverages,fats/oils,
Angel Parker: legumes/nuts/seeds,beverages,eggs,confections,seafood,grains,
Caleb Gentry: dairy,vegetables,fruit,eggs,alcohol,
Amelie Rodriguez: vegetables,meat,fruit,dairy,grains,legumes/nuts/seeds,
Henry Leonard: alcohol,grains,meat,eggs,beverages,fats/oils,
Demi Trujillo: beverages,grains,legumes/nuts/seeds,
Apollo Beard: eggs,fruit,grains,dairy,alcohol,meat,
Ezra Barajas: eggs,fruit,alcohol,legumes/nuts/seeds,seafood,fats/oils,
Brennan Barnett: fats/oils,confections,grains,beverages,
Harlow Jackson: grains,vegetables,meat,confections,fruit,
Sebastian Hobbs: fats/oils,fruit,eggs,confections,
Lacey Willis: vegetables,grains,fruit,seafood,meat,
Remington Reeves: dairy,fruit,eggs,fats/oils,vegetables,beverages,
Lana Hernandez: dairy,eggs,legumes/nuts/seeds,confections,
Mason Hudson: meat,confections,alcohol,beverages,fruit,seafood,eggs,
Kamila Hunt: beverages,fruit,eggs,meat,grains,fats/oils,dairy,
Jesus Jaramillo: confections,dairy,vegetables,fruit,eggs,fats/oils,beverages,
Guadalupe Hahn: legumes/nuts/seeds,beverages,confections,dairy,fats/oils,eggs,alcohol,
Kabir Dyer: beverages,meat,vegetables,fats/oils,seafood,alcohol,dairy,
Estrella Fletcher: vegetables,confections,fruit,legumes/nuts/seeds,fats/oils,
Jay Bruce: fats/oils,confections,alcohol,meat,
Marilyn Tang: grains,eggs,meat,confections,dairy,vegetables,
Rogelio Moss: eggs,seafood,dairy,meat,fats/oils,grains,
Bianca Walter: dairy,alcohol,beverages,
Lochlan Portillo: meat,fats/oils,seafood,vegetables,
Nathalie Hanson: eggs,meat,seafood,confections,grains,dairy,beverages,
Khalil Shepard: fats/oils,beverages,eggs,vegetables,seafood,grains,alcohol,
Noor Wright: eggs,fats/oils,beverages,confections,seafood,meat,fruit,
Grayson Hayes: fats/oils,vegetables,beverages,seafood,eggs,meat,
Iris Crane: alcohol,vegetables,grains,confections,fruit,
Fox Maldonado: vegetables,legumes/nuts/seeds,fats/oils,confections,dairy,eggs,grains,
Elaina Freeman: seafood,vegetables,alcohol,
Jayce Gallegos: dairy,eggs,legumes/nuts/seeds,
Ari Berry: alcohol,fats/oils,fruit,dairy,meat,
Adonis Abbott: meat,grains,seafood,legumes/nuts/seeds,alcohol,beverages,
Melany Monroe: eggs,fruit,dairy,
Colby Cobb: dairy,seafood,confections,beverages,vegetables,
Aviana Peters: alcohol,fruit,grains,meat,dairy,eggs,vegetables,
Patrick Suarez: fruit,dairy,fats/oils,eggs,vegetables,
Jimena Doyle: eggs,meat,fruit,
Kashton Harrison: grains,meat,beverages,alcohol,
Jasmine Jackson: fats/oils,alcohol,grains,vegetables,fruit,dairy,
Sebastian Donovan: seafood,beverages,eggs,legumes/nuts/seeds,confections,
Azariah Beasley: eggs,confections,fruit,dairy,seafood,grains,
Stanley Shelton: vegetables,alcohol,legumes/nuts/seeds,fats/oils,eggs,seafood,
Makenzie Schwartz: seafood,meat,eggs,confections,alcohol,dairy,vegetables,
Edwin Lim: alcohol,meat,fats/oils,fruit,
Giavanna Burke: beverages,confections,meat,grains,fruit,dairy,eggs,
Jax Lam: dairy,eggs,grains,fruit,meat,vegetables,
Karina Gentry: seafood,fruit,alcohol,dairy,legumes/nuts/seeds,eggs,confections,
Magnus Glass: fats/oils,meat,legumes/nuts/seeds,
Clare Schultz: eggs,vegetables,confections,grains,legumes/nuts/seeds,
Cody Roach: eggs,vegetables,seafood,dairy,legumes/nuts/seeds,
Lyanna Blair: legumes/nuts/seeds,meat,eggs,beverages,vegetables,alcohol,
Troy Lozano: vegetables,beverages,fats/oils,seafood,
Cecelia Chavez: vegetables,confections,alcohol,beverages,legumes/nuts/seeds,dairy,fruit,
Ian Newman: dairy,meat,seafood,eggs,alcohol,confections,beverages,
Oaklynn Sexton: legumes/nuts/seeds,seafood,fats/oils,beverages,
Mylo Parks: fats/oils,alcohol,beverages,seafood,confections,fruit,meat,
Ainsley Michael: dairy,fats/oils,fruit,alcohol,meat,
Bronson Payne: fruit,fats/oils,confections,seafood,beverages,
London Kemp: fats/oils,confections,fruit,seafood,grains,
Melvin Steele: eggs,seafood,dairy,meat,
Rylie Greene: alcohol,beverages,vegetables,fats/oils,
Griffin Dominguez: seafood,fruit,confections,eggs,legumes/nuts/seeds,grains,
Raegan Beck: grains,eggs,meat,confections,alcohol,seafood,
Eduardo Anthony: vegetables,alcohol,legumes/nuts/seeds,dairy,eggs,confections,
Macy Snow: seafood,confections,fats/oils,
Houston Shah: legumes/nuts/seeds,fruit,vegetables,
Angelica Coffey: grains,meat,legumes/nuts/seeds,fruit,beverages,confections,vegetables,
Kody Stafford: confections,dairy,alcohol,beverages,
Bridget Casey: legumes/nuts/seeds,grains,alcohol,fruit,eggs,seafood,
Armando Scott: seafood,meat,alcohol,
Aurora Jacobson: confections,beverages,fruit,
Legacy Ochoa: alcohol,dairy,seafood,vegetables,confections,
Luciana Flynn: dairy,legumes/nuts/seeds,alcohol,meat,seafood,fats/oils,
Kannon Compton: eggs,beverages,seafood,
Elina Hull: fats/oils,meat,eggs,
Salem Hobbs: legumes/nuts/seeds,fats/oils,confections,meat,vegetables,seafood,grains,
Lacey Rowe: eggs,fats/oils,vegetables,beverages,
Kamden Perez: fats/oils,eggs,meat,dairy,fruit,grains,
Eleanor Bartlett: eggs,fats/oils,confections,legumes/nuts/seeds,alcohol,
Kace Horne: alcohol,meat,legumes/nuts/seeds,beverages,
Marlowe Myers: beverages,dairy,grains,confections,alcohol,meat,
Adam Walter: confections,seafood,beverages,meat,grains,fats/oils,eggs,
Penny Hutchinson: fruit,meat,seafood,
Korbin Frank: seafood,alcohol,beverages,vegetables,confections,
Dior Graham: eggs,legumes/nuts/seeds,seafood,confections,fats/oils,
Giovanni West: legumes/nuts/seeds,fats/oils,grains,eggs,meat,dairy,
Remi Velez: vegetables,legumes/nuts/seeds,alcohol,
Kareem Austin: fruit,alcohol,eggs,dairy,fats/oils,
Alivia Pope: legumes/nuts/seeds,grains,beverages,alcohol,
Gunnar Hansen: beverages,dairy,fats/oils,eggs,
Hope Meyer: dairy,alcohol,fruit,meat,seafood,
Tristan Long: beverages,eggs,dairy,confections,fats/oils,alcohol,seafood,
Jade Simpson: eggs,meat,beverages,seafood,dairy,
Elliott Ramsey: fats/oils,grains,seafood,vegetables,
Lyric Mays: beverages,dairy,eggs,confections,vegetables,grains,
Jadiel Scott: fats/oils,legumes/nuts/seeds,meat,vegetables,seafood,
Aurora Jenkins: fats/oils,meat,seafood,
Declan Schmidt: fats/oils,beverages,dairy,alcohol,fruit,confections,
Kimberly Esquivel: seafood,legumes/nuts/seeds,grains,meat,vegetables,fats/oils,
Bridger Dickson: eggs,beverages,fruit,fats/oils,
Emmalynn Guzman: beverages,eggs,meat,
Jude Walters: fats/oils,eggs,dairy,
Samara Cano: fats/oils,alcohol,fruit,
Terry Reilly: eggs,legumes/nuts/seeds,grains,vegetables,seafood,meat,
Tori French: eggs,grains,meat,
Corey Orr: vegetables,dairy,legumes/nuts/seeds,grains,alcohol,fruit,beverages,
Alaiya Dodson: seafood,eggs,confections,fats/oils,
Seven Wilkerson: fats/oils,beverages,eggs,
Janiyah Fleming: seafood,eggs,confections,beverages,meat,legumes/nuts/seeds,vegetables,
Fernando Hanson: grains,fats/oils,beverages,
Mariana Lowery: seafood,confections,dairy,meat,
Jaxxon Ford: seafood,meat,fats/oils,fruit,
Alexandra Norton: alcohol,dairy,seafood,
Callen Andrade: meat,legumes/nuts/seeds,vegetables,fats/oils,seafood,grains,alcohol,
Emmy Rush: meat,dairy,vegetables,fats/oils,alcohol,eggs,confections,
Kaiser Shelton: fats/oils,dairy,legumes/nuts/seeds,confections,meat,beverages,seafood,
Makenzie James: beverages,eggs,alcohol,fruit,
Jaxson Conway: fats/oils,beverages,fruit,dairy,grains,vegetables,confections,
Ryann Moore: legumes/nuts/seeds,alcohol,dairy,vegetables,fats/oils,confections,
Levi Parra: beverages,grains,confections,
Dalary Carr: fats/oils,legumes/nuts/seeds,fruit,alcohol,confections,grains,dairy,
Kash Carey: seafood,alcohol,dairy,
Alora Chambers: alcohol,seafood,grains,dairy,legumes/nuts/seeds,vegetables,fats/oils,
Orion Hood: alcohol,vegetables,fruit,
Briana Herring: beverages,dairy,fruit,fats/oils,legumes/nuts/seeds,vegetables,meat,
Henrik Gilmore: seafood,confections,dairy,vegetables,meat,fruit,fats/oils,
Chanel Matthews: beverages,dairy,alcohol,fruit,legumes/nuts/seeds,grains,eggs,
Preston Bradshaw: fruit,legumes/nuts/seeds,confections,seafood,fats/oils,
Berkley Vang: fats/oils,beverages,seafood,
Jimmy Ruiz: meat,eggs,legumes/nuts/seeds,alcohol,grains,
Emery McConnell: vegetables,fruit,dairy,grains,
London Church: fruit,dairy,fats/oils,seafood,legumes/nuts/seeds,eggs,vegetables,
Ayleen Terry: fats/oils,grains,dairy,meat,legumes/nuts/seeds,
Armani Everett: legumes/nuts/seeds,grains,beverages,
Noah Warner: dairy,grains,confections,vegetables,seafood,beverages,fats/oils,
Jaxton Morrow: grains,vegetables,eggs,fruit,seafood,confections,
Reyna Fuentes: confections,vegetables,legumes/nuts/seeds,
Bowen Herring: vegetables,confections,fats/oils,beverages,fruit,meat,
Denver Landry: dairy,seafood,fats/oils,beverages,
Jaxx Stephens: fats/oils,confections,meat,
Millie Strong: grains,fats/oils,meat,seafood,
Axl Blankenship: seafood,eggs,fats/oils,vegetables,meat,fruit,
Rosalee Pope: fats/oils,dairy,legumes/nuts/seeds,fruit,
Gunnar Hickman: seafood,grains,alcohol,eggs,beverages,dairy,
Scarlette Clarke: fruit,fats/oils,seafood,alcohol,dairy,meat,
Stetson Daniel: grains,confections,eggs,alcohol,legumes/nuts/seeds,
Joy Khan: confections,dairy,grains,legumes/nuts/seeds,meat,
Kendrick Sosa: dairy,eggs,fats/oils,
Cassandra Avery: fruit,confections,vegetables,legumes/nuts/seeds,
Jakari Bishop: eggs,beverages,grains,
Brooklynn Friedman: grains,eggs,fats/oils,
Darwin Burnett: legumes/nuts/seeds,vegetables,grains,seafood,confections,meat,alcohol,
Emberly McCann: fats/oils,fruit,vegetables,eggs,
Heath Frye: grains,alcohol,vegetables,
Raya Gilbert: confections,seafood,eggs,dairy,meat,beverages,
Tobias McCann: legumes/nuts/seeds,eggs,seafood,grains,meat,fruit,vegetables,
Joyce Dudley: grains,fruit,meat,confections,legumes/nuts/seeds,beverages,eggs,
Colter Bush: legumes/nuts/seeds,beverages,dairy,
Everlee Galvan: vegetables,grains,seafood,
Kingsley White: vegetables,beverages,seafood,eggs,dairy,fruit,confections,
Layla Yang: dairy,eggs,legumes/nuts/seeds,vegetables,confections,
Malcolm Boyd: eggs,meat,alcohol,confections,dairy,beverages,legumes/nuts/seeds,
Georgia Winters: beverages,vegetables,seafood,legumes/nuts/seeds,confections,dairy,fruit,
Deandre Olsen: vegetables,fruit,meat,legumes/nuts/seeds,
Oaklyn Berg: grains,vegetables,meat,legumes/nuts/seeds,eggs,
Cayson Reilly: beverages,confections,meat,vegetables,fruit,eggs,
Tori Torres: eggs,legumes/nuts/seeds,seafood,alcohol,beverages,confections,
Jayden Shaw: dairy,alcohol,fruit,
Emersyn Trujillo: fats/oils,dairy,beverages,meat,
Apollo Duffy: eggs,beverages,seafood,fruit,alcohol,fats/oils,
Addisyn Miranda: confections,dairy,seafood,eggs,
Rory Chapman: meat,legumes/nuts/seeds,fats/oils,eggs,seafood,alcohol,grains,
Zuri Stanley: beverages,dairy,fruit,vegetables,fats/oils,legumes/nuts/seeds,meat,
Manuel Spencer: grains,fruit,fats/oils,alcohol,seafood,legumes/nuts/seeds,meat,
Alyssa Lopez: eggs,grains,alcohol,
Michael Rice: eggs,seafood,grains,legumes/nuts/seeds,
Ada Stafford: meat,confections,beverages,legumes/nuts/seeds,seafood,
Alfredo Dyer: seafood,vegetables,dairy,legumes/nuts/seeds,alcohol,
Estrella Wade: fats/oils,meat,dairy,confections,legumes/nuts/seeds,eggs,
Jake Andersen: dairy,seafood,beverages,grains,eggs,alcohol,fruit,
Zoie Hines: confections,beverages,eggs,fats/oils,
Uriel Salgado: dairy,confections,seafood,eggs,
Avalynn Leach: beverages,dairy,alcohol,fruit,vegetables,eggs,
Westin Cardenas: confections,legumes/nuts/seeds,eggs,fruit,
Raven Nunez: meat,dairy,fats/oils,
Caden Davenport: seafood,meat,beverages,legumes/nuts/seeds,dairy,
Adrianna Flowers: legumes/nuts/seeds,seafood,alcohol,vegetables,eggs,fruit,
Saul Atkins: eggs,meat,dairy,
Mina Barajas: meat,seafood,vegetables,fats/oils,legumes/nuts/seeds,beverages,eggs,
Brennan Kim: fruit,eggs,legumes/nuts/seeds,vegetables,meat,dairy,
Gabriella Herring: fruit,meat,alcohol,
Henrik Franklin: alcohol,seafood,fats/oils,beverages,vegetables,eggs,confections,
Angela Knight: legumes/nuts/seeds,grains,seafood,eggs,fats/oils,meat,alcohol,
Beckett Summers: fruit,confections,grains,vegetables,fats/oils,seafood,meat,
Frankie Patterson: grains,vegetables,fruit,
Amir Collins: legumes/nuts/seeds,dairy,vegetables,fruit,beverages,meat,
Kinsley Merritt: meat,fats/oils,seafood,
Colten Villanueva: seafood,grains,confections,
Monroe Moore: dairy,eggs,fruit,grains,confections,alcohol,
Levi Day: legumes/nuts/seeds,seafood,alcohol,dairy,grains,confections,
Hayden Wyatt: vegetables,legumes/nuts/seeds,fruit,meat,fats/oils,grains,confections,
Sam Sanford: meat,dairy,grains,
Emerald Mullins: dairy,meat,eggs,alcohol,legumes/nuts/seeds,
Allen Walters: fats/oils,legumes/nuts/seeds,beverages,dairy,seafood,fruit,
Samara Ochoa: fruit,eggs,legumes/nuts/seeds,
Winston Dean: alcohol,legumes/nuts/seeds,vegetables,
Julianna Morton: beverages,alcohol,confections,meat,
Roland Donovan: legumes/nuts/seeds,confections,vegetables,beverages,meat,eggs,
Azariah Oâ€™Connor: dairy,alcohol,confections,fats/oils,
Princeton Wade: fruit,alcohol,grains,dairy,seafood,
Evie Graham: alcohol,dairy,vegetables,beverages,fats/oils,eggs,
Giovanni Spencer: eggs,dairy,meat,grains,confections,vegetables,alcohol,
Alyssa Hayes: eggs,meat,dairy,
Legend Wallace: legumes/nuts/seeds,confections,fruit,dairy,
Arianna Kim: alcohol,dairy,grains,fats/oils,beverages,confections,
Roman Mills: beverages,legumes/nuts/seeds,seafood,fats/oils,
June Ray: vegetables,meat,seafood,beverages,grains,dairy,legumes/nuts/seeds,
Arlo Waters: legumes/nuts/seeds,dairy,fruit,seafood,confections,eggs,
Bristol Kelley: fats/oils,seafood,dairy,fruit,eggs,grains,vegetables,
Eric Charles: legumes/nuts/seeds,beverages,meat,confections,alcohol,fruit,
Jenna Pratt: dairy,alcohol,vegetables,seafood,fats/oils,confections,grains,
Rowen English: fats/oils,alcohol,fruit,vegetables,legumes/nuts/seeds,
Kelly Curtis: eggs,fruit,beverages,meat,
Muhammad Wagner: eggs,beverages,meat,fruit,confections,
Maeve Bonilla: dairy,alcohol,eggs,vegetables,fats/oils,grains,
Aden Farrell: grains,legumes/nuts/seeds,fruit,dairy,confections,eggs,
Kassidy Conner: confections,fats/oils,alcohol,seafood,beverages,legumes/nuts/seeds,dairy,
Phillip McCarthy: fats/oils,confections,seafood,dairy,alcohol,meat,
Kira Figueroa: seafood,vegetables,eggs,confections,legumes/nuts/seeds,dairy,
Spencer Boone: alcohol,eggs,beverages,vegetables,
Mariam Cruz: legumes/nuts/seeds,fats/oils,fruit,
Ryan Watson: alcohol,vegetables,seafood,
Hailey Anthony: alcohol,fats/oils,grains,
Shiloh Leach: fruit,vegetables,eggs,legumes/nuts/seeds,
Martha Ayers: beverages,legumes/nuts/seeds,alcohol,grains,dairy,seafood,
Ulises Schwartz: seafood,legumes/nuts/seeds,fruit,
Lilliana Bernard: seafood,alcohol,dairy,legumes/nuts/seeds,
Jair McCarthy: alcohol,seafood,legumes/nuts/seeds,beverages,grains,meat,
Kira Singleton: vegetables,eggs,seafood,meat,legumes/nuts/seeds,beverages,fats/oils,
Landyn Keith: grains,eggs,alcohol,
Elyse Curtis: eggs,meat,grains,dairy,legumes/nuts/seeds,beverages,alcohol,
Muhammad Crawford: alcohol,fruit,grains,confections,
Aubree Chan: eggs,meat,confections,seafood,vegetables,
Frank Curry: vegetables,eggs,grains,legumes/nuts/seeds,dairy,
Alison Pierce: grains,eggs,fruit,
Nicolas Fowler: fats/oils,dairy,vegetables,alcohol,seafood,confections,beverages,
Lennon Meyer: vegetables,fats/oils,fruit,
Tristan Daniels: vegetables,beverages,alcohol,legumes/nuts/seeds,meat,seafood,
Ember Buchanan: fruit,alcohol,vegetables,confections,eggs,
Enrique Macias: legumes/nuts/seeds,fruit,seafood,meat,beverages,vegetables,fats/oils,
Adley Ramos: legumes/nuts/seeds,fats/oils,dairy,confections,fruit,grains,
Angel Clements: confections,legumes/nuts/seeds,seafood,fats/oils,eggs,grains,meat,
Cara Larson: meat,beverages,seafood,alcohol,eggs,vegetables,
Rafael Fischer: beverages,vegetables,grains,confections,eggs,
Maci Holmes: confections,vegetables,dairy,alcohol,legumes/nuts/seeds,
King Aguilar: fats/oils,vegetables,dairy,beverages,confections,grains,eggs,
Josie Wilson: alcohol,eggs,legumes/nuts/seeds,fruit,beverages,
Daniel Harmon: legumes/nuts/seeds,confections,fats/oils,grains,
Maren Shannon: alcohol,vegetables,grains,meat,beverages,
Eliel Carson: confections,dairy,vegetables,fruit,meat,seafood,beverages,
Nalani Palmer: meat,confections,seafood,vegetables,
Theo Adams: grains,confections,dairy,eggs,alcohol,fats/oils,
Stella Barber: seafood,legumes/nuts/seeds,meat,fats/oils,vegetables,fruit,
Solomon Andersen: meat,grains,vegetables,seafood,confections,legumes/nuts/seeds,eggs,
Zoie Schneider: vegetables,beverages,grains,dairy,eggs,
Raymond Stark: meat,grains,seafood,beverages,eggs,fruit,confections,
Kamilah Clay: seafood,fruit,grains,eggs,beverages,dairy,meat,
Yosef Manning: alcohol,fats/oils,grains,legumes/nuts/seeds,fruit,confections,dairy,
Jennifer Lindsey: grains,legumes/nuts/seeds,meat,fats/oils,dairy,vegetables,
Jayson Rodgers: grains,dairy,fruit,alcohol,beverages,eggs,legumes/nuts/seeds,
Selah Woodward: meat,alcohol,fats/oils,vegetables,fruit,
Jeremias Hughes: grains,legumes/nuts/seeds,fruit,beverages,fats/oils,
Samantha Middleton: alcohol,vegetables,seafood,fruit,confections,beverages,
Misael Miranda: eggs,meat,alcohol,seafood,dairy,confections,grains,
Amina Cantrell: meat,dairy,seafood,
Harris Jones: fats/oils,eggs,dairy,confections,
Sophia Heath: eggs,beverages,vegetables,alcohol,fruit,confections,grains,
Lionel Foster: eggs,dairy,fats/oils,seafood,meat,beverages,confections,
Brielle Brandt: legumes/nuts/seeds,grains,dairy,beverages,confections,fats/oils,eggs,
Damir Ho: grains,beverages,eggs,vegetables,meat,dairy,
Calliope Briggs: alcohol,seafood,vegetables,legumes/nuts/seeds,grains,confections,
Case Cannon: eggs,beverages,dairy,
Noa Enriquez: seafood,beverages,grains,
Elisha Haley: legumes/nuts/seeds,fruit,dairy,meat,
Addilynn Mosley: fats/oils,alcohol,grains,
Rayden Washington: eggs,meat,vegetables,beverages,dairy,seafood,
Valerie Campos: fruit,eggs,meat,seafood,vegetables,confections,alcohol,
Gideon Stout: fruit,eggs,alcohol,meat,fats/oils,beverages,grains,
Chana Cain: meat,seafood,beverages,confections,eggs,alcohol,
Benson Sherman: fats/oils,beverages,eggs,legumes/nuts/seeds,vegetables,alcohol,
Addilyn Vaughn: beverages,fruit,dairy,fats/oils,alcohol,legumes/nuts/seeds,
Remy Wyatt: seafood,fats/oils,dairy,vegetables,
Liberty McIntosh: dairy,legumes/nuts/seeds,fats/oils,alcohol,beverages,fruit,eggs,
Kristian McClure: beverages,seafood,vegetables,legumes/nuts/seeds,grains,confections,eggs,
Estella Sloan: legumes/nuts/seeds,confections,grains,
Ocean Villalobos: confections,alcohol,legumes/nuts/seeds,dairy,
Zoya Sullivan: grains,meat,vegetables,eggs,beverages,
Evan Banks: alcohol,seafood,grains,confections,legumes/nuts/seeds,
Cali Williamson: dairy,vegetables,legumes/nuts/seeds,eggs,seafood,fruit,confections,
Emerson Whitehead: dairy,beverages,alcohol,legumes/nuts/seeds,grains,vegetables,seafood,
Sylvie Wilson: seafood,alcohol,grains,
Daniel Wilkins: eggs,seafood,meat,fruit,
Amalia Baldwin: fruit,legumes/nuts/seeds,alcohol,eggs,seafood,dairy,
Jaiden Schaefer: legumes/nuts/seeds,fats/oils,meat,grains,confections,fruit,alcohol,
Mavis Singleton: vegetables,fruit,confections,fats/oils,legumes/nuts/seeds,seafood,
Landyn Padilla: eggs,alcohol,grains,fruit,
Maggie Williamson: seafood,dairy,beverages,
Emerson Madden: seafood,eggs,fruit,confections,
Violette Galindo: vegetables,eggs,fats/oils,beverages,grains,dairy,confections,
Salvatore Rios: grains,beverages,seafood,confections,fruit,fats/oils,
Brooke Price: beverages,meat,alcohol,legumes/nuts/seeds,fats/oils,confections,vegetables,
Brooks Barajas: grains,alcohol,eggs,beverages,seafood,legumes/nuts/seeds,fats/oils,
Keilani Jordan: fruit,fats/oils,legumes/nuts/seeds,beverages,seafood,meat,dairy,
Sawyer Orozco: meat,seafood,vegetables,dairy,alcohol,beverages,grains,
Renata Patel: dairy,fats/oils,alcohol,legumes/nuts/seeds,confections,meat,beverages,
Parker Spence: vegetables,seafood,fruit,meat,eggs,fats/oils,dairy,
Aislinn Vargas: fats/oils,legumes/nuts/seeds,meat,fruit,beverages,
Ryker McPherson: confections,alcohol,vegetables,fats/oils,dairy,meat,
